WWWWWWWW
WWW0000W
WWW0000W
W00X000W
W00000XW
WWWWWWWW
4,2
4,3
5,5
