WWWWWW
W000WW
WX0X0W
W0000W
W000WW
WWWWWW
5,2
4,3
4,4

