WWWWWWWWWW
WX00000X0W
W00000000W
W00000000W
W00000000W
WWWWWWWWWW
5,3
3,8
3,2
