WWWWWWW
W0000WW
W00000W
W0WX0XW
W00000W
WWWWWWW
3,3
2,2
2,3
