WWWWWWWW
WWW0000W
WWW0000W
W00X000W
W00000XW
WWWWWWWW
2,4
3,4
4,2
