0WWWWW0
WW000WW
W00W00W
W00X00W
W00X00W
WW0X0WW
0WWWWW0
2,3
4,3
5,3
6,3
